











:::        :::::::::: :::     ::: :::::::::: :::              ::::::::        ::::::::  :::        ::::::::::     :::     :::::::::  ::: 
:+:        :+:        :+:     :+: :+:        :+:             :+:    :+:      :+:    :+: :+:        :+:          :+: :+:   :+:    :+: :+: 
+:+        +:+        +:+     +:+ +:+        +:+                   +:+       +:+        +:+        +:+         +:+   +:+  +:+    +:+ +:+ 
+#+        +#++:++#   +#+     +:+ +#++:++#   +#+                 +#+         +#+        +#+        +#++:++#   +#++:++#++: +#++:++#:  +#+ 
+#+        +#+         +#+   +#+  +#+        +#+               +#+           +#+        +#+        +#+        +#+     +#+ +#+    +#+ +#+ 
#+#        #+#          #+#+#+#   #+#        #+#              #+#            #+#    #+# #+#        #+#        #+#     #+# #+#    #+#     
########## ##########     ###     ########## ##########      ##########       ########  ########## ########## ###     ### ###    ### ###
