









 ::::::::   :::::::       :::   ::: ::::::::::     :::     :::::::::   ::::::::       :::            ::: ::::::::::: :::::::::: :::::::::  
:+:    :+: :+:   :+:      :+:   :+: :+:          :+: :+:   :+:    :+: :+:    :+:      :+:          :+: :+:   :+:     :+:        :+:    :+: 
       +:+ +:+  :+:+       +:+ +:+  +:+         +:+   +:+  +:+    +:+ +:+             +:+         +:+   +:+  +:+     +:+        +:+    +:+ 
    +#++:  +#+ + +:+        +#++:   +#++:++#   +#++:++#++: +#++:++#:  +#++:++#++      +#+        +#++:++#++: +#+     +#++:++#   +#++:++#:  
       +#+ +#+#  +#+         +#+    +#+        +#+     +#+ +#+    +#+        +#+      +#+        +#+     +#+ +#+     +#+        +#+    +#+ 
#+#    #+# #+#   #+#         #+#    #+#        #+#     #+# #+#    #+# #+#    #+#      #+#        #+#     #+# #+#     #+#        #+#    #+# 
 ########   #######          ###    ########## ###     ### ###    ###  ########       ########## ###     ### ###     ########## ###    ###
