











:::        :::::::::: :::     ::: :::::::::: :::               :::         ::::::::  :::        ::::::::::     :::     :::::::::  ::: 
:+:        :+:        :+:     :+: :+:        :+:             :+:+:        :+:    :+: :+:        :+:          :+: :+:   :+:    :+: :+: 
+:+        +:+        +:+     +:+ +:+        +:+               +:+        +:+        +:+        +:+         +:+   +:+  +:+    +:+ +:+ 
+#+        +#++:++#   +#+     +:+ +#++:++#   +#+               +#+        +#+        +#+        +#++:++#   +#++:++#++: +#++:++#:  +#+ 
+#+        +#+         +#+   +#+  +#+        +#+               +#+        +#+        +#+        +#+        +#+     +#+ +#+    +#+ +#+ 
#+#        #+#          #+#+#+#   #+#        #+#               #+#        #+#    #+# #+#        #+#        #+#     #+# #+#    #+#     
########## ##########     ###     ########## ##########      #######       ########  ########## ########## ###     ### ###    ### ###














